############
#        O #
#    P  ####
#          #
#######    #
# O  ##    #
#    ##    #
#          #
#    XX    #
#    #     #
############